.........S............................S.........
.........P............................P.........
.........P............................P.........
.........P............................P.........
SPPPPPPPPPPPPPPPPPPPPPPPPPPPPPPPPPPPPPPPPPPPPPPS
.........P............................P.........
.........P............................P.........
.........P............................P.........
.........P........PPPPPPPPPPPP........P.........
.........P........P..........P........P.........
.........P........P..........P........P.........
.........P........P..........P........P.........
.........P........P..........P........P.........
SPPPPPPPPPPPPPPPPPPPPPPPPPPPPPPPPPPPPPPPPPPPPPPS
.........P........P..........P........P.........
.........P........P..........P........P.........
.........P........P..........P........P.........
.........P........P..........P........P.........
.........P........PPPPPPPPPPPP........P.........
.........P............................P.........
.........P............................P.........
.........P............................P.........
SPPPPPPPPPPPPPPPPPPPPPPPPPPPPPPPPPPPPPPPPPPPPPPS
.........P............................P.........
.........P............................P.........
.........P............................P.........
.........S............................S.........