3
................................................
................................................
................................................
................................................
................................................
................................................
................................................
................................................
...........PPPP.................................
..........P....P................................
..........P....P................................
..........P....P................................
SPPPPPPPPPPPPPPPPPPPPPPPPPPPPPPPPPPPPPPPPPPPPPPS
................................................
......................PPPP......................
......................PT.P......................
......................P..P......................
......................PPPP......................
................................................
................................................
................................................
................................................
................................................
................................................
................................................
................................................
................................................
