4
................................................
................................................
................................................
................................................
SP.....................T......................PS
..P..........................................P..
...P........................................P...
....PPPPP..............................PPPPP....
.........PPPPP....................PPPPP.........
..............PPPPPP........PPPPPP..............
....................P......P....................
.....................P....P.....................
..........T...........P..P......................
.......................PP...........T...........
......................P..P......................
.....................P....P.....................
....................P......P....................
..............PPPPPP........PPPPPP..............
.........PPPPP....................PPPPP.........
....PPPPP..............................PPPPP....
...P........................................P...
..P..........................................P..
SP.....................T......................PS
................................................
................................................
................................................
................................................